3031311311111312
2222110231312222
2223111222022222
2200312221322122
2111222222221222
3112220202210222
2122211110213022
2222131113223122
2221021122022202
2211311021102112
2113231123131102
3102221102223112
2310211110222222
2230311311002222
2021030211110302
1111111111111010



