31111312

21310222

22213022

02302302

23030210

22103032

21113102

31020112

11111110
