1332200332312112103100002222100
2013321130312333221322113101210
0021020110120331132011010323130
3002112023111022002221113133022
3120032203032013323320330000110
1201212320211110023122312100200
3111321221100001212010102200332
0231103303100213232112230110212
0322211013210202202201102331132
3320013203011221001311102311222
1333230000032213130231201312132
2233013103223101101011233301022
2210312011121320201302302120222
1000302111120330301201000022322
3021112020233003213113312200102
2231333131221221303323212230322
2301121320222012323302303110110
1111031312322230301301232320122
2123331123313202300020231013332
0201110312022323121303332300210
1332321123013201213222300303202
2011301100301322003301122332020
0211002003321231111332030332302
1023110123123211330203330200312
3202021230022220022332232330200
0333032213300000311202013103030
0130130122300023102133321023222
2021323232301322223122320101030
1320122000030331120132321310032
0103122022021232003122222020212
1100112231132320032211012221230
0203030101202011023113230131110
0030303011132120030101010220200
1322213212220031033001020202130
1112223230100011210121002203220
1021011112023001220220303302220
1012321023312211203123131200200
2130102230100331020000001102230
1203123010022001330320123022002
1223212320211030201233123321200
1010101001001100110000000011010
