100303033231133301322011322
131323113313231121131120232
122101110113033323000321232
023311212130331302312223332
202000000103010120222232310
200122312323021110122132202
123212320302331013310003332
213312102112202113212021122
203220133321330201231303000
333321203021232002211122120
213312322211330032100223030
310003001101000113313211220
331221221300012021300131130
320112121301200031201113222
111201023223032122222313102
103311021001020201222100210
301222120201002001122020132
322223311212122012013013022
103222231212333033100001000
100033201001100201030121322
333022311300110132131231230
001322332021233312112100202
011223322030220033102212020
102011302000001330122002302
112200021332131101222113302
212122020122031303323112102
100110110110100101110100010
