3321330010
2031331112
1100011012
1212110330
2121130102
2201012312
0223321022
0021133202
0211220022
2001131110
0110233110
3220130020
1303310012
1322313030
0000022022
0112222030
2100132032
2011111110
0210230300
0101000100
