311113113113111131110
303123121120303023102
212220211213030210312
221033110302310330222
231120331230221021222
223103022221311132102
300302312011211203122
223302220310232130222
302020311031002103022
231123033023112122122
223021002201121213202
202113121131212320222
231210211202120211222
221231112122311310212
212222120222222031302
220231211212223102112
223021102222020131122
230311302302311221202
223031030222212312122
302103303022122211022
231110232311202303022
223031022230310310302
202123102021231213022
231210211132102112322
221231112221231122202
212222120212221202312
220231212320312122222
223021102213011022222
230223122123111312022
223222122202111023102
302021222313311122112
231112022022031022302
223023111323112123022
202122112022221220222
231210211122231023022
221223112220203130302
212222120213130303022
320231212320223030312
223021102211223030222
010311102110202121102
111111111111111111110